e2e2e2e2e2e2e2e2e2e2e2e2e2e2e2e2e2e2e2e2e2e2e2e2e2e2e2e2e2e2e2e3
e2e200000000000000270000000000010000000000000000000008090000e2e3
e2e200000000000000000000000020210000000000000000000028290000e2e2
e2e2e0e0e0e00000e0e0e0e0e0e0e0e0e0e0e00000e0e0c0c1e0e0e0e0e0e0e0
e2e36465102000000080900000000000000000000000000c0c10000000000e2e3
e2e38485102000000282900000000000000000000000000c0c10000000000e2e3
e3e3a4a5102000000000000000000000000000000000000c0c10000000000e2e3
e1e1e1e1e1e1e1e1e1e1e10000e1e1e1c0c1e1e1e10000e1e1e1e1e1e1e1e1e1
e2e30000080900000000000000000000c0c10000000010200080900000000e2e3
e2e30000282900000027000000000000c0c10000270010200282900000000e2e3
e2e30000000000000000000000000000c0c10000000110200000000008081e2e3
e2e30000000000000000000000000000c0c1000020211020000000000a0a1e2e3
e0e0e0e0e0e0e0e0e0e0e0e00000e0e0c0c1e0e0e0e0e0e00000e0c0c1e0e0e0
e2e30000000000080900000000000000c0c1000000000000000000c0c100e2e3
e2e30000000000282900000000000000c0c1000000000000000000c0c100e2e3
e2e30000000000010000000000000000c0c1000000000027000000c0c100e2e3
e2e30000000020210000000000000000c0c1000000000000000000202100e2e3
e0e1e0e0c0c1e1e1e10000e1e1e1e1e1e1e1e10000e1e1e1c0c1e1e1e1e1e1e1
e2e30000c0c1000000000000000008090000000000000000c0c100000809e2e3
e2e30000c0c1000027000000000028290000000000000000c0c100002829e2e3
e2e30000c0c1000000000000000000000000010000000000c0c100000000e2e3
e2e30000c0c1000000000000000000000020210000000000c0c100000000e2e3
e0e0e0e0e0e0e0e0e0e0e0e0e0e0e0e0e0e0e0e0e0e0e0e0e0e0e0e0e0e0e0e0
